Abbad - Tekun beribadah
Abbas - Singa
Abduh - Hamba-Nya
Abdulah, Abdullah - Hamba Allah
Abdul Alim - Hamba dari Yang Maha Tahu
Abdul Aliyy - Hamba dari Yang Maha Tinggi
Abdul Azim - Hamba dari Yang Maha Agung
Abdul Aziz - Hamba dari Yang Maha Perkasa
Abdul Bari - Hamba dari Sang Pembuat
Abdul Basit - Hamba dari Yang Maha Dalam
Abdul Fattah - Hamba dari Sang Pembuka (rahmat)
Abdul Ghoffar, Abdul Ghafur - Hamba dari Sang Pengampun
Abdul Hadi - Hamba dari Sang Pemberi Petunjuk
Abdul Hafiz - Hamba dari Sang Penjaga
Abdul Hakam - Hamba dari Sang Penetap Hukum
Abdul Hakim - Hamba dari Yang Maha Bijaksana
Abdul Halim - Hamba dari Yang Maha lembut
Abdul Hamid - Hamba dari Yang Maha Terpuji
Abdul Haqq - Hamba dari Yang Maha Benar
Abdul Hasib - Hamba dari Sang Penghitung
Abdul Jabbar - Hamba dari Yang Maha Kuat
Abdul Jalil - Hamba dari Yang Maha Perkasa
Abdul Karim - Hamba dari Yang Maha Pemurah
Abdul Khaliq - Hamba dari Sang Pencipta
Abdul Latif - Hamba dari Yang Maha Halus
Abdul Malik - Hamba dari Maha Segala Raja
Abdul Majid - Hamba dari Yang Maha Hebat
Abdul Matin - Hamba dari Yang Maha Kuat
Abdul Muhaimin - Hamba dari Sang Penjaga
Abdul Mu’izz - Hamba dari Pemberi Kemenangan
Abdul Mujib - Hamba dari Sang Pemberi
Abdul Muta’al - Hamba dari Yang Paling Tinggi
Abdul Nasser - Hamba dari Sang Penolong
Abdul Nasir - Hamba dari Sang Penolong
Abdul Qadir - Hamba dari Sang Pemberi ketetapan
Abdul Qahhar - Hamba dari Sang Pemaksa
Abdul Quddus - Hamba dari Yang Maha Suci
Abdul Rafi - Hamba dari Sang Peninggi (derajat)
Abdul Rahim - Hamba dari Yang Maha Penyayang
Abdul Rahman - Hamba dari Yang Maha Pengasih
Abdul Rashid - Hamba dari Sang Pemberi Jalan Kebenaran
Abdul Ra’uf - Hamba dari Sang Pengampun
Abdul Razzaq - Hamba dari Sang Pemberi Rizki
Abdul Sabur - Hamba dari Yang Maha Penyabar
Abdul Salam - Hamba dari Yang Maha Damai
Abdul Samad - Hamba dari Yang Maha Kekal
Abdul Sami - Hamba dari Sang Pendengar
Abdul Shakur - Hamba dari Sang Penyukur
Abdul Tawwab - Hamba dari Yang Maha Pengampun
Abdul Wadud - Hamba dari Sang Pencinta
Abdul Wahhab - Hamba dari Sang Pemberi
Abdul Wahid - Hamba dari Yang Maha Esa
Abid - Hamba yang beribadah
Abidin - Hamba-hamba, ahli ibadah
Abiyy - Penuh kehormatan dan kemuliaan diri
Abrar - Golongan yang berbuat kebaikan
Abu Bakar - Nama sahabat Rasulullah SAW
Adham - Tali rantai, Peninggalan kuno
Adib - Beradab, Sastrawan
Adil - Persamaan, kesataraan, adil
Adli - Bersifat setara, adil
Adnan - Penduduk, pemukim
Afdhal - Paling banyak keutamaan dan kemuliaannya
Affan - Menjaga diri dari yang tak halal
Afi - Pengampun 66. Afif - Punya harga diri
Aflah - Lebih sukses
Aghlab - Sering menang
Ahmad - Terpuji, Salah satu nama Rasulullah SAW
Ahnaf - Orang yang lurus, lebih suci
Ahsan - Orang yang paling utama
Akhdan - Sahabat
Akif - Beritikaf
Akil - Berakal
Akmal - Lengkap, Sempurna
Akram - Sangat dermawan, lebih Mulia
Ala - Tinggi, mulia
Al Baihaqi - Imam perawi hadist
Ali - Tinggi
Alif - Orang yang senang dengan manusia dan disenangi
Alim - Berilmu
Althaf - Llembut
Amid - Pemimpin
Amin - Pemegang amanat, Terpercaya
Amir - Memakmurkan, pemimpin
Amjad - Lebih mulia, sangat hebat
Ammar - Pembangun
Amrullah - Perintah Allah
Anas - Mesra, periang
Anis -Sopan
Anjab - Berharga
Anmar - Murni, bermanfaat, kebaikan dan kesehatan
Anshar - Penolong, kaum anshar sahabat nabi SAW
Anwar - Cahaya, sinar
Aqib - Balasan yang baik
Aqil - Berakal, cerdas
Arafat - Padang Arafah
Arib - Cerdas
Arif - Tahu, bijaksana
Arij - Wangi, harum
Arkan - Orang yang kuat
As’ad - Bahagia
Asad - Singa
Ashim - Pemimpin yang mulia
Asif - Pemaaf
Asim - Pelindung, penjaga
Aslam - Selamat
Aswad-Hitam
Asyfaq - Lebih baik dan sehat
Asyja’ - Sangat pemberani
Asyraf - Lebih mulia
Atha - Anugerah, pemberian, rezeki
Aththabarani - Imam perawi hadist
Attirmidzi - Imam perawi hadist
Atif - Simpatik
Atqa - Orang yang lebih bertakwa
Aufa - Lebih tepat
Aun - Pertolongan
Awad - Hadiah
Awwab - Senang bertaubat
Ayman - Beruntung, Sebelah Kanan
Ayub - Nama seorang Nabi
Aza - Sejuk, Tenang
Azhar - Yang cerah bercahaya, lebih cerah
Aziz - Orang yang kuat
Azka - Orang yang paling bersih dan suci
Azmi - Keteguhan hati
